   NO		textures/east.xpm
SO textures/tmp_south.xpm
WE          		 textures/west.xpm
EA textures/east.xpm
C 0,   0 ,0
F   50,   50,50
               111
1111111111111111011111111111111111
111100000010000000000010000000001
111100000010000000000010000000011
111100000010000000000010000000011
111100000000000000000000000000011
111100000000110111011100000000011
111100000000000000N00000000000011
111100000000000000000000000000011
111111111111111111111111111111111
111111111111101111111111111111111
111111111111111111111111111111111

