   NO		textures/east.xpm
SO textures/tmp_south.xpm
WE          		 textures/weast.xpm
EA textures/east.xpm
C 0,   0 ,0
F   50,   50,50
               111
1111111111111111D11111111111111111
111100000010000000000010000000001
111100000010000000000010000000011
111100000010000000000010000000011
111100000000000000000000000000011
11111111111111D111D11111111111111
111100000000000000W00000000000011
111100000000000000000000000000011
111111000000001111110000000011111111111
11111100000000111111000000001111111111
111100000000000000000000000000000000011
11111100000000111D110000000011111111111
11111100000000111111000000001111111
11110000000000D00001000000000000011
11111100000000100001000011111111111
      11111111 1111 1111
   11111111     111111111
1110000000011111100000000111111111111
111100000000000000000000000000000000011
1111110000000011111100000000111111111111111111111
11111100000000111111000000001111111111111111111111
111100000000000000000000000000000000011
111111000000001111110000000011111111111
11111100000000111111000000001111111
111111111111111111111111111111111

